{ "map" : [
	[1,1,1,1,1,1,1,1,1,1,1,1,1,1,1,1,1,1,1,1,1,1,1,1,1,1,1,1,1,1,1,1],
	[1,0,0,0,0,0,0,0,0,0,0,0,0,0,0,0,0,0,0,0,0,0,0,0,0,0,0,0,0,0,0,1],
	[1,0,0,3,3,3,0,0,0,0,0,0,0,0,0,0,0,0,0,0,0,0,0,0,0,0,0,0,0,0,0,1],
	[1,0,0,3,0,3,0,0,1,1,1,2,1,1,1,1,1,2,1,1,1,2,1,0,0,0,0,0,0,0,0,1],
	[1,0,0,3,0,4,0,0,0,0,0,0,0,0,0,0,0,0,0,0,0,0,0,0,0,0,0,0,0,0,0,1],
	[1,0,0,0,0,3,0,0,0,0,0,0,0,0,0,0,0,0,0,0,0,0,0,0,0,0,0,0,0,0,0,1],
	[1,0,0,0,0,3,0,0,0,0,0,0,0,0,0,0,0,0,0,0,0,0,0,0,0,0,3,1,1,1,1,1],
	[1,0,0,3,0,3,0,0,0,0,0,0,0,0,0,0,0,0,0,0,0,0,0,0,0,0,0,0,0,0,0,1],
	[1,0,0,3,0,4,0,0,0,0,0,0,0,0,0,0,0,0,0,0,0,0,0,0,0,0,0,0,0,0,0,2],
	[1,0,0,3,0,3,0,0,0,0,0,0,0,0,0,0,0,0,0,0,0,0,0,0,0,0,0,0,0,0,0,1],
	[1,0,0,3,3,3,0,0,0,0,0,0,0,0,0,0,0,0,0,0,0,0,0,0,0,0,3,1,1,1,1,1],
	[1,0,0,0,0,0,0,0,0,0,0,0,0,0,0,0,0,0,0,0,0,0,0,0,0,0,0,0,0,0,0,1],
	[1,0,0,0,0,0,0,0,0,3,3,3,0,0,3,3,3,0,0,0,0,0,0,0,0,0,0,0,0,0,0,2],
	[1,0,0,0,0,0,0,0,0,3,3,3,0,0,3,3,3,0,0,0,0,0,0,0,0,0,0,0,0,0,0,1],
	[1,0,0,0,0,0,0,0,0,3,3,3,0,0,3,3,3,0,0,0,0,0,0,0,0,0,3,1,1,1,1,1],
	[1,0,0,0,0,0,0,0,0,3,3,3,0,0,3,3,3,0,0,0,0,0,0,0,0,0,0,0,0,0,0,1],
	[1,0,0,4,0,0,4,2,0,2,2,2,2,2,2,2,2,0,2,4,4,0,0,4,0,0,0,0,0,0,0,1],
	[1,0,0,4,0,0,4,0,0,0,0,0,0,0,0,0,0,0,0,0,4,0,0,4,0,0,0,0,0,0,0,1],
	[1,0,0,4,0,0,4,0,0,0,0,0,0,0,0,0,0,0,0,0,4,0,0,4,0,0,0,0,0,0,0,1],
	[1,0,0,4,0,0,4,0,0,0,0,0,0,0,0,0,0,0,0,0,4,0,0,4,0,0,0,0,0,0,0,1],
	[1,0,0,4,3,3,4,2,2,2,2,2,2,2,2,2,2,2,2,2,4,3,3,4,0,0,0,0,0,0,0,1],
	[1,0,0,0,0,0,0,0,0,0,0,0,0,0,0,0,0,0,0,0,0,0,0,0,0,0,0,0,0,0,0,1],
	[1,0,0,0,0,0,0,0,0,0,0,0,0,0,0,0,0,0,0,0,0,0,0,0,0,0,0,0,0,0,0,1],
	[1,1,1,1,1,1,1,1,1,1,1,1,1,1,1,1,1,1,1,1,1,1,1,1,1,1,1,1,1,1,1,1]
],
  "globalLight" : 0.5,
  "textures": [
    {"src": "https://i.imgur.com/f49O4mp.png", "width": 128, "height" : 128},
    {"src": "https://i.imgur.com/i0HjXM4.png", "width": 128, "height" : 128},
    {"src": "https://i.imgur.com/6oNpeh1.png", "width": 128, "height" : 128},
    {"src": "https://i.imgur.com/gncmQpa.png", "width": 128, "height" : 128}
  ],
 "lights":  [
   {"range": 10, "x" : 1, "y" : 1},
   {"range": 10, "x" : 1, "y" : 10}
 ]
}
